N:
end.level
T:
default
A:
3
a roomlink 03.level linkPointTop
b linkPoint linkPointBot
c enemy boss
L:
##############################
##############################
####11##11##11##11##11##11####
###111111111111111111111111###
##11111111111111111111111111##
##11111111111111111111111111##
###111111111111111111111111###
###111111111111111111111111###
##1111111111111c111111111111##
##11111111111111111111111111##
###111111111111111111111111###
###111111111111111111111111###
##11111111111111111111111111##
##11111111111111111111111111##
###111111111111111111111111###
###111111111111111111111111###
##11111111111111111111111111##
##11111111111111111111111111##
###111111111111111111111111###
###111111111111111111111111###
##11111111111111111111111111##
##11111111111111111111111111##
###111111111111111111111111###
###111111111111111111111111###
##11111111111111111111111111##
##111111111111#S#11111111111##
###11111111111#b#1111111111###
####1##11##11##a#1##11##11####
###############B##############
###############B##############
