N:
test_level_1
T:
default
A:
2
a enemy enemy_testEnemy
b roomlink link_test_level_01_right link_test_level_02_left
L:
##############################
##############################
##############################
##############################
######     ###################
###### #######################
######    #########      #####
###################  ##  #####
######    S  ######  ##  #####
###### ##  # ######  ##  #####
######       ######      #####
######  ## # #################
####### ## # #################
##########   #################
##############a   b###########
############## C #############
##############   #############
##############################
##############################
##############################
##############   #############
################ #############
##############   #############
##############################
##############################
##############################
##############################
##############################
##############################
##############################
