N:
test_level_1
T:
default
A:
2
a enemy enemy_testEnemy
b roomlink link_test_level_01_right link_test_level_02_left
L:
##############################
###111##11####11##111#####11##
#1###1##111##1111#1###11##1###
#11#111#1#######111##11111111#
##111111111##11##11111########
###11##11####1##11#####1111b01
#111##11##1#11#111#111#1######
###1#111111111111####111#1111#
#1#1########1########1######1#
#1#1##111##111#11#1#11#11###1#
#1#11111###1#1#1111#111111111#
#1##11#####1#1####1#1#########
#11111111##111#1111111111111##
##11###111##11#11#######11#1##
########111##1##1#1#111#1##1##
10a1111##111#1####111######1##
######11##111111###1##111111##
#11#1##11######11##1111###11##
#1##11##111111111#######11111#
#1#1111###1########1111111####
#111##111111111#1111#####1#11#
#1#1##########1#1#1########11#
#1#1#1111#111###1#1#111##1##1#
#11111####11111#1###1111#11#1#
#1#111#11####11#111###11#11#1#
#1###111######1###111#1111111#
#111#1#1111111111###1##111##1#
#1#1######111###1#1111###1####
#1#111111#1#####1111111111111#
##############################
