N:
test_level_1
T:
default
A:
4
a enemy enemy_testEnemy
b spawnPoint thisismytgesdfsdf
c spawnPoint wjateverrrrrr
d asdfa asd fasf
L:
##############################
###111##11####11##111#####11##
#1###1##111##1111#1###11##1###
#11#111#1#######111##11111E11#
##111111111##11##11111########
###11##11####1##11#####11dcBBB
#111##11##1#11#111#111#1######
###1#111111111111####111#1111#
#1#1########1########1######1#
#1#1##111##111#11#1#11#11###1#
#1#11111###1#1#1111#111111111#
#1##11#####1#1####1#1#########
#11111111##111#1111111111111##
##11###111##11#11#######11#1##
########111##1##1#1#111#1##1##
BBBabS1##111#1####111######1##
######11##111111###1##111111##
#11#1##11######11##1111###11##
#1##11##111111111#######11111#
#1#1111###1########1111111####
#111##111111111#1111#####1#11#
#1#1############1#1########11#
#1#1#1111#111###1#1#111##1##1#
#11111####11111#1###1111#11#1#
#1#111#11####11#111###11#11#1#
#1###111######1###111#1111111#
#111#1#1111111111###1##111##1#
#1#1######111###1#1111###1####
#1#111111#1#####1111111111111#
##############################
